libio_shapes
--------------------------------
libio_shapes: 0	:Export GStat Shapes
libio_shapes: 1	:Import GStat Shapes
libio_shapes: 2	:Export Shapes to XYZ
libio_shapes: 3	:Import Shapes from XYZ
libio_shapes: 4	:Export Shapes to Generate
libio_shapes: 5	:Export Surfer Blanking File
libio_shapes: 6	:Import Surfer Blanking Files
libio_shapes: 7	:Export Atlas Boundary File
libio_shapes: 8	:Import Atlas Boundary File
libio_shapes: 9	:Export WASP terrain map file
libio_shapes: 10	:Import WASP terrain map file
libio_shapes: 11	:Import Stereo Lithography File (STL)
libio_shapes: 12	:Export TIN to Stereo Lithography File (STL)
libio_shapes: 13	:Import GPX
libio_shapes: 14	:Export GPX
libio_shapes: 15	:Import Point Cloud from Shape File
libio_shapes: 16	:Import Point Cloud from Text File
libio_shapes: 17	:Export Scalable Vector Graphics (SVG) File
libio_shapes: 18	:Export Point Cloud to Text File


liblectures_introduction
--------------------------------
liblectures_introduction: 0	:01 My first module
liblectures_introduction: 1	:02 Pixel by pixel operations with two grids
liblectures_introduction: 2	:03 Direct neighbours
liblectures_introduction: 3	:04 Direct neighbours 
liblectures_introduction: 4	:05 Direct neighbours 
liblectures_introduction: 5	:06 Extended neighbourhoods
liblectures_introduction: 6	:07 Extended neighbourhoods 
liblectures_introduction: 7	:08 Extended neighbourhoods 
liblectures_introduction: 8	:09 Extended neighbourhoods 
liblectures_introduction: 9	:10 Dynamic Simulation 
liblectures_introduction: 10	:11: Dynamic Simulation 
liblectures_introduction: 11	:12: First steps with shapes
liblectures_introduction: 12	:13: Reprojecting a shapes layer
liblectures_introduction: 13	:14: Vectorising channel lines


libtable_calculus
--------------------------------
libtable_calculus: 0	:Function Fit
libtable_calculus: 1	:Table Calculator
libtable_calculus: 2	:Table Calculator (Shapes)
libtable_calculus: 3	:Trend Analysis
libtable_calculus: 4	:Trend (Analysis) Shapes
libtable_calculus: 5	:Running Average
libtable_calculus: 6	:Cluster Analysis
libtable_calculus: 7	:Principle Components Analysis
libtable_calculus: 8	:Fill Gaps in Records
libtable_calculus: 9	:PET (after Hargreave)
libtable_calculus: 10	:Daily to Hourly PET


libgeostatistics_regression
--------------------------------
libgeostatistics_regression: 0	:Regression Analysis (Points/Grid)
libgeostatistics_regression: 1	:Multiple Regression Analysis (Points/Grids)
libgeostatistics_regression: 2	:Polynomial Regression
libgeostatistics_regression: 3	:Geographically Weighted Regression
libgeostatistics_regression: 4	:Geographically Weighted Regression (Points/Grid)
libgeostatistics_regression: 5	:Geographically Weighted Multiple Regression
libgeostatistics_regression: 6	:Geographically Weighted Multiple Regression (Points/Grids)
libgeostatistics_regression: 7	:Geographically Weighted Multiple Regression (Points)
libgeostatistics_regression: 8	:Multiple Regression Analysis (Grid/Grids)


libgrid_visualisation
--------------------------------
libgrid_visualisation: 0	:Color Palette Rotation
libgrid_visualisation: 1	:Color Blending
libgrid_visualisation: 2	:Fit Color Palette to Grid Values
libgrid_visualisation: 3	:RGB Composite
libgrid_visualisation: 4	:Create 3D Image
libgrid_visualisation: 5	:Color Triangle Composite
libgrid_visualisation: 6	:Histogram Surface


libtransect
--------------------------------
libtransect: 0	:Transect through polygon shapefile


libshapes_points
--------------------------------
libshapes_points: 0	:Convert Table to Points
libshapes_points: 1	:Count Points in Polygons
libshapes_points: 2	:Create Point Grid
libshapes_points: 3	:Distance Matrix
libshapes_points: 4	:Fit N Points to shape
libshapes_points: 5	:Convert Lines to Points
libshapes_points: 6	:Add Coordinates to points
libshapes_points: 7	:Remove Duplicate Points
libshapes_points: 8	:Clip Points with Polygons
libshapes_points: 9	:Separate points by direction
libshapes_points: 10	:Add Polygon Attributes to Points
libshapes_points: 11	:Points Filter
libshapes_points: 12	:Convex Hull
libshapes_points: 14	:Points Thinning
libshapes_points: 15	:Convert Multipoints to Points
libshapes_points: 16	:Thiessen Polygons
libshapes_points: 17	:Aggregate Point Observations


libsim_hydrology
--------------------------------
libsim_hydrology: 0	:Soil Moisture Content
libsim_hydrology: 1	:Overland Flow 
libsim_hydrology: 2	:TOPMODEL
libsim_hydrology: 3	:Water Retention Capacity


libgrid_spline
--------------------------------
libgrid_spline: 0	:Thin Plate Spline (Global)
libgrid_spline: 1	:Thin Plate Spline (Local)
libgrid_spline: 2	:Thin Plate Spline (TIN)
libgrid_spline: 3	:B-Spline Approximation
libgrid_spline: 4	:Multilevel B-Spline Interpolation
libgrid_spline: 5	:Multilevel B-Spline Interpolation (from Grid)
libgrid_spline: 6	:Cubic Spline Approximation


libta_hydrology
--------------------------------
libta_hydrology: 0	:Catchment Area (Parallel)
libta_hydrology: 1	:Catchment Area (Recursive)
libta_hydrology: 2	:Catchment Area (Flow Tracing)
libta_hydrology: 4	:Upslope Area
libta_hydrology: 6	:Flow Path Length
libta_hydrology: 7	:Slope Length
libta_hydrology: 10	:Cell Balance
libta_hydrology: 13	:Edge Contamination
libta_hydrology: 15	:SAGA Wetness Index
libta_hydrology: 16	:Lake Flood
libta_hydrology: 18	:Catchment Area (Mass-Flux Method)
libta_hydrology: 19	:Flow Width and Specific Catchment Area
libta_hydrology: 20	:Topographic Wetness Index (TWI)
libta_hydrology: 21	:Stream Power Index
libta_hydrology: 22	:LS Factor


libpointcloud_tools
--------------------------------
libpointcloud_tools: 0	:Point Cloud Cutter
libpointcloud_tools: 2	:Point Cloud from Grid Points
libpointcloud_tools: 3	:Point Cloud from Shapes
libpointcloud_tools: 4	:Point Cloud to Grid
libpointcloud_tools: 5	:Point Cloud to Shapes
libpointcloud_tools: 6	:Point Cloud Reclassifier / Subset Extractor
libpointcloud_tools: 7	:Drop Point Cloud Attribute
libpointcloud_tools: 8	:Transform Point Cloud
libpointcloud_tools: 9	:Point Cloud Thinning (simple)
libpointcloud_tools: 10	:Point Cloud Attribute Calculator
libpointcloud_tools: 11	:Cluster Analysis for Point Clouds


libgrid_tools
--------------------------------
libgrid_tools: 0	:Resampling
libgrid_tools: 1	:Aggregate
libgrid_tools: 3	:Merging
libgrid_tools: 4	:Create Constant Grid
libgrid_tools: 5	:Patching
libgrid_tools: 6	:Close One Cell Gaps
libgrid_tools: 7	:Close Gaps
libgrid_tools: 8	:Grid Buffer
libgrid_tools: 9	:Threshold Buffer
libgrid_tools: 10	:Grid Proximity Buffer
libgrid_tools: 11	:Convert Data Storage Type
libgrid_tools: 12	:Change Grid Values
libgrid_tools: 15	:Reclassify Grid Values
libgrid_tools: 17	:Crop to Data
libgrid_tools: 18	:Invert Data/No-Data
libgrid_tools: 19	:Grid Orientation
libgrid_tools: 20	:Combine Grids
libgrid_tools: 21	:Sort Grid
libgrid_tools: 22	:Grids from classified grid and table
libgrid_tools: 23	:Create Grid System
libgrid_tools: 24	:Grid Masking
libgrid_tools: 25	:Close Gaps with Spline
libgrid_tools: 26	:Proximity Grid
libgrid_tools: 27	:Tiling
libgrid_tools: 28	:Grid Shrink/Expand


libdocs_pdf
--------------------------------
libdocs_pdf: 0	:Shapes Report
libdocs_pdf: 1	:Shapes Summary Report
libdocs_pdf: 2	:Terrain Path Cross Sections


libimagery_tools
--------------------------------
libimagery_tools: 0	:Vegetation Index[distance based]
libimagery_tools: 1	:Vegetation Index[slope based]


librecreations_fractals
--------------------------------
librecreations_fractals: 0	:Bifurcation
librecreations_fractals: 1	:Pythagoras' Tree
librecreations_fractals: 3	:Fractal Dimension of Grid Surface
librecreations_fractals: 5	:Gaussian Landscapes


libio_shapes_las
--------------------------------
libio_shapes_las: 0	:Export LAS Files
libio_shapes_las: 1	:Import LAS Files
libio_shapes_las: 2	:LAS Info


libta_compound
--------------------------------
libta_compound: 0	:Basic Terrain Analysis


libio_gdal
--------------------------------
libio_gdal: 0	:GDAL: Import Raster
libio_gdal: 1	:GDAL: Export Raster
libio_gdal: 2	:GDAL: Export Raster to GeoTIFF
libio_gdal: 3	:OGR: Import Vector Data
libio_gdal: 4	:OGR: Export Vector Data


libio_esri_e00
--------------------------------
libio_esri_e00: 0	:Import ESRI E00 File


libdocs_html
--------------------------------
libdocs_html: 1	:SVG Interactive Map


libgrid_gridding
--------------------------------
libgrid_gridding: 0	:Shapes to Grid
libgrid_gridding: 1	:Inverse Distance Weighted
libgrid_gridding: 2	:Nearest Neighbour
libgrid_gridding: 3	:Natural Neighbour
libgrid_gridding: 4	:Modifed Quadratic Shepard
libgrid_gridding: 5	:Triangulation
libgrid_gridding: 6	:Kernel Density Estimation


libta_channels
--------------------------------
libta_channels: 0	:Channel Network
libta_channels: 1	:Watershed Basins
libta_channels: 2	:Watershed Basins (Extended)
libta_channels: 3	:Vertical Distance to Channel Network
libta_channels: 4	:Overland Flow Distance to Channel Network
libta_channels: 5	:Channel Network and Drainage Basins
libta_channels: 6	:Strahler Order


libio_grid_image
--------------------------------
libio_grid_image: 0	:Export Image (bmp, jpg, pcx, png, tif)
libio_grid_image: 1	:Import Image (bmp, jpg, png, tif, gif, pnm, xpm)


libgeostatistics_grid
--------------------------------
libgeostatistics_grid: 0	:Fast Representativeness
libgeostatistics_grid: 1	:Residual Analysis (Grid)
libgeostatistics_grid: 2	:Representativeness (Grid)
libgeostatistics_grid: 3	:Radius of Variance (Grid)
libgeostatistics_grid: 4	:Statistics for Grids
libgeostatistics_grid: 5	:Zonal Grid Statistics
libgeostatistics_grid: 6	:Directional Statistics for Single Grid
libgeostatistics_grid: 7	:Global Moran's I for Grids
libgeostatistics_grid: 8	:Principle Components Analysis
libgeostatistics_grid: 9	:Multi-Band Variation


libio_grid_grib2
--------------------------------
libio_grid_grib2: 0	:Import GRIB2 record


libtin_tools
--------------------------------
libtin_tools: 0	:Grid to TIN
libtin_tools: 1	:Grid to TIN (Surface Specific Points)
libtin_tools: 2	:Shapes to TIN
libtin_tools: 3	:TIN to Shapes
libtin_tools: 4	:Gradient
libtin_tools: 5	:Flow Accumulation (Trace)
libtin_tools: 6	:Flow Accumulation (Parallel)


libgrid_filter
--------------------------------
libgrid_filter: 0	:Simple Filter
libgrid_filter: 1	:Gaussian Filter
libgrid_filter: 2	:Laplacian Filter
libgrid_filter: 3	:Multi Direction Lee Filter
libgrid_filter: 4	:User Defined Filter
libgrid_filter: 5	:Filter Clumps
libgrid_filter: 6	:Majority Filter
libgrid_filter: 7	:DTM Filter (slope-based)
libgrid_filter: 8	:Morphological Filter
libgrid_filter: 9	:Rank Filter


libshapes_tools
--------------------------------
libshapes_tools: 0	:Create New Shapes Layer
libshapes_tools: 2	:Merge Shapes Layers
libshapes_tools: 3	:Select by Attributes... (Numerical Expression)
libshapes_tools: 4	:Select by Attributes... (String Expression)
libshapes_tools: 5	:Select by Location...
libshapes_tools: 6	:Copy Selection to New Shapes Layer
libshapes_tools: 7	:Delete Selection from Shapes Layer
libshapes_tools: 8	:Invert Selection of Shapes Layer
libshapes_tools: 9	:Split Shapes Layer Completely
libshapes_tools: 10	:Transform Shapes
libshapes_tools: 11	:Create Chart Layer (bars/sectors)
libshapes_tools: 12	:Create Graticule
libshapes_tools: 13	:Cut Shapes Layer
libshapes_tools: 15	:Split Shapes Layer
libshapes_tools: 16	:Split Shapes Layer Randomly
libshapes_tools: 17	:Split Table/Shapes by Attribute
libshapes_tools: 18	:Shapes Buffer
libshapes_tools: 19	:Get Shapes Extents
libshapes_tools: 20	:QuadTree Structure to Shapes
libshapes_tools: 21	:Polar to Cartesian Coordinates


libshapes_lines
--------------------------------
libshapes_lines: 0	:Convert Polygons to Lines
libshapes_lines: 1	:Convert Points to Line(s)
libshapes_lines: 2	:Line Properties
libshapes_lines: 3	:Line-Polygon Intersection
libshapes_lines: 4	:Line Simplification
libshapes_lines: 5	:Line Dissolve


libgeostatistics_points
--------------------------------
libgeostatistics_points: 0	:Variogram
libgeostatistics_points: 1	:Variogram Cloud
libgeostatistics_points: 2	:Variogram Surface
libgeostatistics_points: 3	:Minimum Distance Analysis
libgeostatistics_points: 4	:Spatial Point Pattern Analysis


libio_shapes_dxf
--------------------------------
libio_shapes_dxf: 0	:Import DXF Files


libpointcloud_viewer
--------------------------------
libpointcloud_viewer: 0	:Point Cloud Viewer


libta_lighting
--------------------------------
libta_lighting: 0	:Analytical Hillshading
libta_lighting: 2	:Potential Incoming Solar Radiation
libta_lighting: 3	:Sky View Factor
libta_lighting: 4	:Topographic Correction


libgrid_calculus_bsl
--------------------------------
libgrid_calculus_bsl: 0	:BSL
libgrid_calculus_bsl: 1	:BSL from File


libgarden_webservices
--------------------------------
libgarden_webservices: 0	:Import a Map via Web Map Service (WMS)


libio_table
--------------------------------
libio_table: 0	:Export Text Table
libio_table: 1	:Import Text Table
libio_table: 2	:Import Text Table with Numbers only
libio_table: 3	:Import Text Table (Fixed Column Sizes)


libio_odbc
--------------------------------
libio_odbc: 0	:ODBC Connect
libio_odbc: 1	:ODBC Disconnect
libio_odbc: 2	:ODBC Commit/Rollback Transaction
libio_odbc: 3	:ODBC Execute SQL
libio_odbc: 4	:Table Field Description
libio_odbc: 5	:Table Import
libio_odbc: 6	:Table Export
libio_odbc: 7	:Table Deletion
libio_odbc: 8	:Table from Query
libio_odbc: 9	:Points Import
libio_odbc: 10	:Points Export
libio_odbc: 11	:PostGIS Shapes Import
libio_odbc: 12	:PostGIS Shapes Export


libgrid_analysis
--------------------------------
libgrid_analysis: 0	:Accumulated Cost (Isotropic)
libgrid_analysis: 1	:Accumulated Cost (Anisotropic)
libgrid_analysis: 5	:Least Cost Paths
libgrid_analysis: 6	:Change Vector Analysis
libgrid_analysis: 7	:Covered Distance
libgrid_analysis: 8	:Pattern Analysis
libgrid_analysis: 9	:Layer of extreme value
libgrid_analysis: 10	:Analytical Hierarchy Process
libgrid_analysis: 11	:Ordered Weighted Averaging (OWA)
libgrid_analysis: 12	:Aggregation Index
libgrid_analysis: 13	:Cross-Classification and Tabulation
libgrid_analysis: 14	:Soil Texture Classification
libgrid_analysis: 15	:Fragmentation (Standard)
libgrid_analysis: 16	:Fragmentation (Alternative)
libgrid_analysis: 17	:Fragmentation Classes from Density and Connectivity


libta_preprocessor
--------------------------------
libta_preprocessor: 0	:Flat Detection
libta_preprocessor: 1	:Sink Drainage Route Detection
libta_preprocessor: 2	:Sink Removal
libta_preprocessor: 3	:Fill Sinks (Planchon/Darboux, 2001)
libta_preprocessor: 4	:Fill Sinks (Wang & Liu)
libta_preprocessor: 5	:Fill Sinks XXL (Wang & Liu)
libta_preprocessor: 6	:Burn Stream Network into DEM


libta_morphometry
--------------------------------
libta_morphometry: 0	:Slope, Aspect, Curvature
libta_morphometry: 1	:Convergence Index
libta_morphometry: 2	:Convergence Index (Search Radius)
libta_morphometry: 3	:Surface Specific Points
libta_morphometry: 4	:Curvature Classification
libta_morphometry: 5	:Hypsometry
libta_morphometry: 6	:Real Area Calculation
libta_morphometry: 7	:Morphometric Protection Index
libta_morphometry: 8	:Multiresolution Index of Valley Bottom Flatness (MRVBF)
libta_morphometry: 9	:Downslope Distance Gradient
libta_morphometry: 10	:Mass Balance Index
libta_morphometry: 11	:Effective Air Flow Heights
libta_morphometry: 12	:Diurnal Anisotropic Heating
libta_morphometry: 13	:Land Surface Temperature
libta_morphometry: 14	:Relative Heights and Slope Positions
libta_morphometry: 15	:Wind Effect (Windward / Leeward Index)
libta_morphometry: 16	:Terrain Ruggedness Index (TRI)
libta_morphometry: 17	:Vector Ruggedness Measure (VRM)
libta_morphometry: 18	:Topographic Position Index (TPI)
libta_morphometry: 19	:TPI Based Landform Classification


libimagery_classification
--------------------------------
libimagery_classification: 0	:Supervised Classification
libimagery_classification: 1	:Cluster Analysis for Grids
libimagery_classification: 2	:Change Detection
libimagery_classification: 3	:Decision Tree


libtable_tools
--------------------------------
libtable_tools: 0	:Create New Table
libtable_tools: 1	:Transpose Table
libtable_tools: 2	:Enumerate Table Field
libtable_tools: 3	:Join Attributes from a Table
libtable_tools: 4	:Join Attributes from a Table (Shapes)
libtable_tools: 5	:Change Date Format
libtable_tools: 6	:Change Time Format


libshapes_polygons
--------------------------------
libshapes_polygons: 0	:Polygon Intersection
libshapes_polygons: 1	:Polygon Centroids
libshapes_polygons: 2	:Polygon Properties
libshapes_polygons: 3	:Convert Lines to Polygons
libshapes_polygons: 4	:Point Statistics for Polygons
libshapes_polygons: 5	:Polygon Dissolve
libshapes_polygons: 6	:Convert Polygon/Line Vertices to Points
libshapes_polygons: 7	:Polygon Shape Indices
libshapes_polygons: 8	:Polygon-Line Intersection
libshapes_polygons: 9	:Polygons to Edges and Nodes
libshapes_polygons: 10	:Polygon Parts to Separate Polygons


libpj_georeference
--------------------------------
libpj_georeference: 1	:Georeferencing 
libpj_georeference: 2	:Georeferencing 


libimagery_rga
--------------------------------
libimagery_rga: 0	:Fast Region Growing Algorithm


libgeostatistics_kriging
--------------------------------
libgeostatistics_kriging: 0	:Ordinary Kriging (VF)
libgeostatistics_kriging: 1	:Ordinary Kriging (VF, Global)
libgeostatistics_kriging: 2	:Universal Kriging (VF)
libgeostatistics_kriging: 3	:Universal Kriging (VF, Global)
libgeostatistics_kriging: 4	:Variogram (Dialog))
libgeostatistics_kriging: 5	:Ordinary Kriging
libgeostatistics_kriging: 6	:Ordinary Kriging (Global)
libgeostatistics_kriging: 7	:Universal Kriging
libgeostatistics_kriging: 8	:Universal Kriging (Global)


libio_grid
--------------------------------
libio_grid: 0	:Export ESRI Arc/Info Grid
libio_grid: 1	:Import ESRI Arc/Info Grid
libio_grid: 2	:Export Surfer Grid
libio_grid: 3	:Import Surfer Grid
libio_grid: 4	:Import Binary Raw Data
libio_grid: 5	:Export Grid to XYZ
libio_grid: 6	:Import Grid from XYZ
libio_grid: 7	:Import USGS SRTM Grid
libio_grid: 8	:Import MOLA Grid (MEGDR)
libio_grid: 9	:Import SRTM30 DEM
libio_grid: 10	:Export True Color Bitmap
libio_grid: 11	:Import Erdas LAN/GIS
libio_grid: 12	:Import Grid from Table
libio_grid: 13	:Import WRF Geogrid Binary Format
libio_grid: 14	:Export WRF Geogrid Binary Format


libsim_cellular_automata
--------------------------------
libsim_cellular_automata: 0	:Conway's Life
libsim_cellular_automata: 1	:Wa-Tor


libsim_ecosystems_hugget
--------------------------------
libsim_ecosystems_hugget: 0	:01: A Simple Litter System
libsim_ecosystems_hugget: 1	:02: Carbon Cycle Simulation for Terrestrial Biomass
libsim_ecosystems_hugget: 2	:03: Spatially Distributed Simulation of Soil Nitrogen Dynamics


libcontrib_a_perego
--------------------------------
libcontrib_a_perego: 0	:Average With Thereshold 1
libcontrib_a_perego: 1	:Average With Thereshold 2
libcontrib_a_perego: 2	:Average With Thereshold 3
libcontrib_a_perego: 3	:Average With Mask 1
libcontrib_a_perego: 4	:Average With Mask 2
libcontrib_a_perego: 5	:Destriping 1
libcontrib_a_perego: 6	:Destriping 2
libcontrib_a_perego: 7	:Directional Average 1


libshapes_grid
--------------------------------
libshapes_grid: 0	:Add Grid Values to Points
libshapes_grid: 1	:Add Grid Values to Shapes
libshapes_grid: 2	:Grid Statistics for Polygons
libshapes_grid: 3	:Grid Values to Points
libshapes_grid: 4	:Grid Values to Points (randomly)
libshapes_grid: 5	:Contour Lines from Grid
libshapes_grid: 6	:Vectorising Grid Classes
libshapes_grid: 7	:Clip Grid with Polygon
libshapes_grid: 9	:Local Minima and Maxima
libshapes_grid: 10	:Grid System Extent
libshapes_grid: 15	:Gradient Vectors from Surface
libshapes_grid: 16	:Gradient Vectors from Direction and Length
libshapes_grid: 17	:Gradient Vectors from Directional Components


libgarden_3d_viewer
--------------------------------
libgarden_3d_viewer: 0	:3D Shapes Viewer


libpj_proj4
--------------------------------
libpj_proj4: 0	:Set Coordinate Reference System
libpj_proj4: 1	:Coordinate Transformation (Shapes List)
libpj_proj4: 2	:Coordinate Transformation (Shapes)
libpj_proj4: 3	:Coordinate Transformation (Grid List)
libpj_proj4: 4	:Coordinate Transformation (Grid)
libpj_proj4: 5	:Proj.4 (Command Line Arguments, Shapes)
libpj_proj4: 6	:Proj.4 (Dialog, Shapes)
libpj_proj4: 7	:Proj.4 (Command Line Arguments, Grid)
libpj_proj4: 8	:Proj.4 (Dialog, Grid)
libpj_proj4: 9	:Proj.4 (Command Line Arguments, List of Shapes Layers)
libpj_proj4: 10	:Proj.4 (Dialog, List of Shapes Layers)
libpj_proj4: 11	:Proj.4 (Command Line Arguments, List of Grids)
libpj_proj4: 12	:Proj.4 (Dialog, List of Grids)


libihacres
--------------------------------
libihacres: 0	:IHACRES Calibration (2)
libihacres: 1	:IHACRES Version 1.0
libihacres: 2	:IHACRES Basin
libihacres: 3	:IHACRES Elevation Bands
libihacres: 4	:IHACRES Elevation Bands Calibration


libtin_viewer
--------------------------------
libtin_viewer: 0	:TIN Viewer


libgrid_calculus
--------------------------------
libgrid_calculus: 0	:Grid Normalisation
libgrid_calculus: 1	:Grid Calculator
libgrid_calculus: 2	:Grid Volume
libgrid_calculus: 3	:Grid Difference
libgrid_calculus: 4	:Function
libgrid_calculus: 5	:Geometric Figures
libgrid_calculus: 6	:Random Terrain Generation
libgrid_calculus: 7	:Random Field
libgrid_calculus: 8	:Grids Sum
libgrid_calculus: 9	:Grids Product
libgrid_calculus: 10	:Grid Standardisation
libgrid_calculus: 11	:Fuzzify
libgrid_calculus: 12	:Fuzzy Intersection (AND)
libgrid_calculus: 13	:Fuzzy Union (OR)
libgrid_calculus: 14	:Metric Conversions
libgrid_calculus: 15	:Gradient Vector from Cartesian to Polar Coordinates
libgrid_calculus: 16	:Gradient Vector from Polar to Cartesian Coordinates
libgrid_calculus: 17	:Polynomial Trend from Grids
libgrid_calculus: 18	:Grid Division


libimagery_segmentation
--------------------------------
libimagery_segmentation: 0	:Watershed Segmentation
libimagery_segmentation: 1	:Grid Skeletonization
libimagery_segmentation: 2	:Seed Generation
libimagery_segmentation: 3	:Simple Region Growing


libio_gps
--------------------------------
libio_gps: 0	:GPX to shapefile
libio_gps: 1	:GPSBabel


libta_profiles
--------------------------------
libta_profiles: 3	:Cross Profiles
libta_profiles: 4	:Profiles from Lines
libta_profiles: 5	:Profile from points


